R 2147483648 48012312312312
SO srcs/cube_functions/textures/barrel.png
S srcs/cube_functions/textures/sprite_1.xpm
NO srcs/cube_functions/textures/wall_2.xpm
F 0220,0100,06
EA srcs/cube_functions/textures/wall_3.xpm
WE srcs/cube_functions/textures/wall_4.xpm
C 255,255,15

22222
11111
11211
10001
10001
10N01
10001
10001
11111